150 200
150 150
300 200
1111111111111111111
1200000000100000021
1000000000100000001
1000000000000000001
1000000000100000001
1000000000100000001
1000000000111111111
1000000000000000001
1000000000000000001
1111111111111111111
